111111111110
100P00000001
10000E000001
1000000C0001
111111111111
