111111111111111
100101001011001
100010000CC0011
110001000001111
1000100PC000011
100000010000011
1110C0000011001
1100000C0001101
1E000010000C011
111111111111111
