111111111111111111111
1E    1      1  C   1
1111  1  C   1111   1
1 C1  1    111      1
1          1     P  1
1    C              1
111111111111111111111
