111111111110
1  P       1
1     E    1
1        C 1
111111111111
